Gg, Gg, Cea, Gg, Gg, Gg, Gg, Gg, Gg, Gg, Gg, Gg, Gg, Gg, Gg, Gg, Gg, Gg, Gg, Gg, Gg, Gg, Gg, Gg, Ds, Wot, Wot, Wot, Wot, Wot, Wot, Wot, Wot, Ds, Aa, Gg, Gg, Gg, Gg, Gg, Gg, Gg, Gg, Gg, Gg, Gg
Gg, Cea, Cea, Cea, Cea, Cea, Gg, Gg, Gg, Gg, Re^Vct, Gg, Gg, Gg, Gg, Gg, Gg, Gg, Gg, Gg, Gg, Gg, Gg, Ds, Ds, Wwr, Wwr, Ww, Ww, Ww, Wwr, Wwr, Wwr, Ds, Aa, Gg, Gg, Gg, Gg, Gg, Gg, Gg, Gg, Gg, Gg, Gg
Gg, Cea, Cea, 2 Ke, Cea, Cea, Gg, Gg, Gg, Gg, Gg, Gg, Gg, Gg, Gg, Gg, Gg, Gg, Re^Vct, Gg, Gg, Gg, Gg, Ds, Ds, Wwr, Wwr, Ww, Ww, Ww, Ww, Wwr, Wwr, Ds, Aa, Gg, Gg, Gg, Gg, Gg, Gg, Gg, Gg, Gg, Gg, Gg
Gg, Cea, Cea, Cea, Cea, Cea, Gg, Gg, Gg, Gg, Gg, Gg, Gg, Gg, Gg, Gg, Gg, Gg, Gg, Gg, Gg, Gg, Gg, Ds, Ds, Wwr, Wwr, Ww, Ww, Ww, Ww, Wwr, Wwr, Ds, Aa, Gg, Gg, Gg, Gg, Gg, Gg, Gg, Gg, Gg, Gg, Gg
Gg, Cea, Cea, Cea, Cea, Cea, Gg, Gg, Gg, Gg, Gg, Gg, Gg, Re^Vct, Gg, Gg, Gg, Gg, Gg, Gg, Gg, Gg, Gg, Ds, Ds, Wwr, Wwr, Ww, Ww, Ww, Ww, Ww, Wwr, Ds, Aa, Gg, Gg, Gg, Gg, Gg, Gg, Gg, Gg, Gg, Gg, Gg
Gg, Gg, Gg, Gg, Gg, Gg, Gg, Gg, Gg, Re^Vct, Gg, Gg, Gg, Gg, Gg, Gg, Gg, Gg, Gg, Re^Vct, Gg, Gg, Gg, Ds, Ds, Wwr, Ww, Ww, Ww, Ww, Wwr, Wwr, Ds, Ds, Aa, Gg, Gg, Gg, Gg, Gg, Gg, Gg, Gg, Gg, Gg, Gg
Gg, Gg, Gg, Gg, Gg, Gg, Gg, Gg, Gg, Gg, Gg, Gg, Gg, Gg, Gg, Gg, Gg, Gg, Gg, Gg, Gg, Gg, Gg, Ds, Ds, Wwr, Ww, Ww, Wwr, Wwr, Wwr, Wwr, Ds, Aa, Aa, Gg, Gg, Gg, Gg, Gg, Gg, Gg, Gg, Gg, Gg, Gg
Gg, Gg, Gg, Re^Vct, Gg, Gg, Gg, Gg, Gg, Gg, Gg, Gg, Gg, Gg, Gg, Gg, Gg, Gg, Gg, Gg, Gg, Gg, Gg, Ds, Ds, Wwr, Wwr, Ww, Ww, Wwr, Ds, Ds, Aa, Aa, Gg, Gg, Gg, Gg, Gg, Gg, Gg, Gg, Gg, Gg, Gg, Gg
Gg, Gg, Re^Vct, Gg, Gg, Gg, Gg, Gg, Gg, Gg, Gg, Re^Vct, Gg, Gg, Gg, Gg, Gg, Gg, Gg, Gg, Gg, Gg, Ds, Ds, Ds, Wwr, Wwr, Ww, Ww, Wwr, Ds, Ds, Aa, Gg, Gg, Gg, Gg, Gg, Gg, Gg, Gg, Gg, Gg, Gg, Gg, Gg
Gg, Gg, Gg, Gg, Gg, Gg, Gg, Gg, Gg, Gg, Gg, Gg, Gg, Gg, Gg, Re^Vct, Gg, Gg, Gg, Gg, Gg, Gg, Ds, Ds, Wwr, Wwr, Ww, Ww, Ww, Wwr, Ds, Ds, Aa, Gg, Gg, Gg, Gg, Gg, Gg, Gg, Gg, Gg, Gg, Gg, Gg, Gg
Gg, Gg, Gg, Gg, Gg, Gg, Gg, Re^Vct, Gg, Gg, Gg, Gg, Gg, Gg, Gg, Gg, Gg, Gg, Gg, Gg, Gg, Ds, Ds, Ds, Wwr, Ww, Ww, Ww, Wwr, Wwr, Ds, Ds, Aa, Gg, Gg, Gg, Gg^Efm, Gg^Efm, Gg, Gg, Gg, Gg, Gg, Gg, Gg, Gg
Gg, Gg, Gg, Gg, Gg, Gg, Gg, Gg, Gg, Gg, Gg, Gg, Gg, Gg, Gg, Gg, Gg^Efm, Gg, Gg, Gg, Ds, Ds, Ds, Wwr, Wwr, Ww, Ww, Ww, Wwr, Ds, Aa, Aa, Gg^Efm, Gg, Gg, Gg^Efm, Gg, Gg, Gg, Gg^Efm, Gg^Efm, Gg, Gg, Gg, Gg, Gg
Gg, Gg, Gg, Gg, Gg^Efm, Gg, Gg, Gg, Gg, Gg, Gg, Gg, Gg, Gg, Gg, Gg^Efm, Gg, Gg, Ds, Ds, Ds, Ds, Wwr, Wwr, Ww, Gg, Ww, Ww, Wwr, Ds, Aa, Gg, Gg, Gg, Gg, Gg, Gg, Gg, Gg, Gg, Gg^Efm, Gg, Gg, Gg, Gg, Gg
Gg, Gg, Gg, Re^Vct, Gg^Efm, Gg^Efm, Gg, Gg, Gg, Gg, Gg, Gg, Gg, Gg, Gg, Gg, Gg, Gg, Ds, Ds, Ds, Wwr, Wwr, Ww, Ww, Ww, Wwr, Wwr, Ds, Ds, Aa, Gg, Gg, Gg, Gg, Gg, Gg, Gg, Gg, Gg, Gg, Gg, Gg, Gg, Gg, Gg
Gg, Gg, Gg, Gg, Gg, Gg, Gg, Gg, Gg, Gg, Gg^Efm, Gg, Gg, Gg, Gg, Gg, Ds, Ds, Ds, Ds, Wwr, Wwr, Ww, Ww, Ww, Ww, Wwr, Ds, Ds, Ds, Aa, Gg^Efm, Gg^Efm, Gg, Gg, Gg, Gg, Gg, Gg^Efm, Gg, Gg, Gg, Gg, Gg, Gg, Gg
Gg, Gg, Gg, Gg, Gg, Gg, Gg, Gg, Gg, Gg^Efm, Gg^Efm, Gg^Efm, Gg^Efm, Gg^Efm, Ds, Ds, Ds, Ds, Wwr, Wwr, Wwr, Ww, Wwr, Wwr, Wwr, Wwr, Ds, Ds, Aa, Aa, Gg, Gg^Efm, Gg, Gg, Gg, Gg, Gg, Gg, Gg, Gg^Efm, Gg^Efm, Gg, Gg, Gg, Gg, Gg
Gg, Gg, Gg, Gg, Gg, Gg^Efm, Gg, Gg, Gg, Gg^Efm, Gg, Gg^Efm, Ds, Ds, Ds, Ds, Wwr, Wwr, Wwr, Wwr, Ww, Ww, Wwr, Wwr, Ds, Ds, Aa, Aa, Gg, Gg, Gg, Gg, Gg, Gg, Gg, Gg, Gg, Gg, Gg, Gg, Gg, Gg, Gg, Gg, Gg, Gg
Gg, Gg, Gg, Gg, Gg, Gg, Gg, Gg, Gg, Gg, Ds, Ds, Ds, Ds, Ds, Wwr, Wwr, Wwr, Ww, Ww, Wwr, Wwr, Ds, Ds, Aa, Aa, Gg, Gg, Gg^Efm, Gg, Gg, Gg, Gg, Gg, Gg, Gg, Gg, Gg, Gg, Gg, Gg, Gg, Gg, Gg, Gg, Gg
Gg, Gg, Gg, Gg, Gg, Gg, Gg, Gg, Ds, Ds, Ds, Ds, Wwr, Wwr, Wwr, Wwr, Ww, Ww, Wwr, Wwr, Ds, Ds, Aa, Aa, Aa, Aa, Gg, Gg, Gg^Efm, Gg, Gg, Gg, Gg, Gg, Gg, Gg, Gg, Gg, Gg, Gg^Efm, Gg, Gg, Gg, Gg, Gg, Gg
Gg, Gg, Gg, Gg, Gg, Gg, Ds, Ds, Ds, Ds, Wwr, Wwr, Ww, Wwr, Ww, Wwr, Ww, Ww, Wwr, Ds, Aa, Aa, Gg, Aa, Gg, Gg, Gg, Gg, Gg, Gg^Efm, Gg^Efm, Gg^Efm, Gg, Gg, Gg, Gg, Gg, Gg, Gg, Gg^Efm, Aa, Gg, Aa, Gg, Gg, Gg
Gg, Gg, Gg, Gg, Gg, Gg^Efm, Ds, Ds, Wwr, Wwr, Ww, Ww, Gg, Ww, Wwr, Ww, Wwr, Wwr, Ds, Ds, Aa, Gg, Gg, Gg, Gg, Gg, Gg, Gg, Gg, Gg^Efm, Gg^Efm, Gg, Aa, Gg, Aa, Aa, Aa, Gg, Gg, Aa, Gg, Aa, Gg, Aa, Aa, Gg
Gg, Gg, Gg, Gg, Gg, Gg, Ds, Ds, Wwr, Wwr, Ww, Ww, Ww, Gg, Wwr, Wwr, Ds, Ds, Aa, Aa, Gg, Gg^Efm, Gg, Gg^Efm, Aa, Aa, Aa, Aa, Aa, Aa, Aa, Aa, Gg, Aa, Aa, Gg, Aa, Aa, Aa, Gg, Aa, Aa, Aa, Aa, Aa, Gg
Gg, Gg, Gg, Gg, Gg, Gg, Ds, Ds, Wwr, Wwr, Wwr, Ww, Ww, Wwr, Wwr, Ds, Aa, Aa, Gg, Gg, Gg, Gg, Aa, Aa, Aa, Aa, Gg, Aa, Aa, Gg, Aa, Aa, Aa, Aa, Aa, Gg, Gg, Aa, Aa, Aa, Gg, Aa, Aa, Aa, Aa, Aa
Gg, Gg, Gg, Gg, Gg, Gg, Ds, Ds, Ds, Wwr, Wwr, Ww, Ww, Wwr, Ds, Ds, Aa, Gg, Gg, Gg, Gg, Aa, Gg, Aa, Aa, Gg, Aa, Aa, Ms^Xm, Aa, Aa, Aa, Aa, Aa, Aa, Gg, Aa, Aa, Aa, Aa, Aa, Aa, Aa, Aa, Aa, Aa
Gg, Gg, Gg, Gg, Gg, Gg, Ds, Ds, Wwr, Wwr, Ww, Ww, Wwr, Wwr, Ds, Aa, Gg, Gg, Gg, Aa, Aa, Aa, Gg, Aa, Gg, Gg, Gg, Ms^Xm, Aa, Aa, Aa, Ms^Xm, Ms^Xm, Ms^Xm, Ms^Xm, Ms^Xm, Ms^Xm, Ms^Xm, Cea, Aa, Ms^Xm, Ms^Xm, Ms^Xm, Ms^Xm, Ms^Xm, Gg
Gg, Gg, Gg, Gg, Gg, Gg, Ds, Ds, Wwr, Ww, Ww, Ww, Wwr, Wwr, Ds, Aa, Gg, Gg, Aa, Aa, Aa, Aa, Aa, Aa, Ms^Xm, Aa, Aa, Aa, Aa, Aa, Cea, Cea, Rr, Aa, Re^Vct, Rb, Rb, Rb, Rr, Cea, Rr, Aa, Rb, Aa, Aa, Rb
Gg, Gg, Gg, Gg, Gg, Gg, Ds, Ds, Wwr, Wwr, Ww, Ww, Wwr, Ds, Aa, Aa, Gg, Aa, Aa, Gg, Aa, Aa, Ms^Xm, Gg, Aa, Aa, Aa, Aa, Ms^Xm, Ms^Xm, Rr, Rr, Rr, Rb, Rb, Rb, Rb, Rb, Rr, Rr, Rr, Rb, Rb, Rb, Rb, Rb
Gg, Gg, Gg, Gg, Gg, Gg, Ds, Ds, Wwr, Wwr, Ww, Wwr, Ds, Aa, Gg, Gg, Gg, Gg, Aa, Gg, Aa, Aa, Ms^Xm, Aa, Aa, Aa, Cea, Ms^Xm, Aa, Aa, Rb, Rr, Rr, Rr, Rr, Rb, Re^Vct, Rb, Rr, Rr, Rr, Re^Vct, Rb, Rb, Rb, Rb
Gg, Gg, Gg, Gg, Gg, Gg, Ds, Ds, Wwr, Ww, Ww, Wwr, Ds, Aa, Gg, Gg, Gg, Gg, Aa, Gg, Aa, Ms^Xm, Aa, Aa, Aa, Cea, Rr, Rr, Rr, Re^Vct, Rb, Rb, Rb, Rr, Rr, Rr, Rr, Rb, Rr, Rr, Rr, Rb, Rb, Re^Vct, Rr, Rb
Gg, Gg, Gg, Gg, Gg, Gg, Ds, Ds, Wwr, Wwr, Ww, Wwr, Ds, Aa, Gg, Gg, Gg, Aa, Aa, Aa, Aa, Aa, Aa, Aa, Ms^Xm, Cea, Rb, Rr, Rr, Rr, Rr, Rb, Rb, Rb, Rb, Rr, Rr, Rr, Rr, Rr, Rr, Rb, Rr, Rr, Rr, Rb
Gg, Gg, Gg, Gg, Gg, Ds, Ds, Wwr, Wwr, Ww, Ww, Wwr, Ds, Aa, Gg, Gg, Gg, Aa, Aa, Aa, Ms^Xm, Aa, Cea, Cea, Rr, Aa, Rb, Rb, Rb, Rr, Rr, Rr, Rr, Re^Vct, Rb, Rb, Rb, Rr, Rr, Rr, Rr, Rr, Rr, Rr, Cea, Rb
Gg, Gg, Gg, Gg, Gg, Ds, Ds, Wwr, Ww, Ww, Ww, Wwr, Ds, Aa, Gg, Gg, Gg, Aa, Gg, Aa, Aa, Ms^Xm, Aa, Rr, Rr, Rr, Rr, Re^Vct, Rb, Rb, Rb, Rr, Rr, Rr, Rr, Rb, Rb, Rb, Rr, Rr, Rr, Rr, Rr, Cea, Cea, Rb
Gg, Gg, Gg, Gg, Gg, Ds, Ds, Wwr, Ww, Ww, Ww, Wwr, Ds, Aa, Gg, Gg, Aa, Aa, Aa, Gg, Ms^Xm, Ms^Xm, Aa, Rb, Rb, Rr, Rr, Rr, Rr, Rb, Rr, Rb, Rb, Rr, Rr, Rr, Rr, Rr, Rr, Rr, Rr, Cea, Cea, Cea, Cea, Rb
Gg, Gg, Gg, Gg, Gg, Ds, Ds, Wwr, Wwr, Ww, Ww, Wwr, Ds, Aa, Gg, Gg, Gg, Gg, Gg, Aa, Ms^Xm, Re^Vct, Rb, Rb, Re^Vct, Rb, Rb, Rr, Rb, Rr, Rr, Rr, Rr, Rr, Rr, Rr, Rr, Rr, Rb, Rr, Rb, Cea, Cea, Cea, 1 Ke, Rb
Gg, Gg, Gg, Gg, Gg, Ds, Ds, Wwr, Wot, Wot, Wot, Wot, Gg, Aa, Gg, Gg, Gg, Aa, Aa, Aa, Gg, Rb, Rb, Rb, Rb, Rb, Rb, Rb, Rb, Rb, Rb, Rb, Rb, Rb, Rb, Rb, Rb, Rb, Rb, Rb, Rb, Cea, Cea, Cea, Rb, Rb
